NO ./textures/mold_wall64.xpm
SO ./textures/brick_wall64.xpm
WE ./textures/candle_wall64.xpm
EA ./textures/axe_wall64.xpm

F 220,100,0
C 0,0,255

11111111111111111
10000000000000001
10000000000000001
10000000000000001
100000000N0000001
10000000000000001
10000000000000001
10000000000000001
10000000000000001
10000000000000001
10000000000000001
10000000000000001
11111111011111111
       101   
11111111011111111
10000000000000001
10000000000000001
10000000000000001
10000000000000001
10000000000000001
10000000000000001
10000000000000001
11111111111111111