NO ./textures/monaliza_pxl_64.xpm
SO ./textures/monettwife_pxl_64.xpm
WE ./textures/noite_pxl_64.xpm
EA ./textures/ogrito_pxl_64.xpm

F 139,69,-1
C 200,200,200

11111111111111111
10000000000000001
10000000000000011
1000000000000001
10000000N0000011
1000000000000001
1000000000000001
111111111111111111