NO ./textures/monaliza_pxl_64.xpm
SO ./textures/monettwife_pxl_64.xpm
WE ./textures/noite_pxl_64.xpm
EA ./textures/ogrito_pxl_64.xpm

F 220,100,0
C  
 
  0,0,255

				 
				  
				   
				    

11111111111111111
10000000000000001
10000000000000001
10000000000000001
100000000E0000001    1111111
11111111111111111    1000001
10000000000000101    1000001
11111111111111111    1111111