NO ./textures/axe_wall64.xpm
SO ./textures/brick_wall64.xpm
WE ./textures/candle_wall64.xpm
EA ./textures/mold_wall64.xpm
F 220,100,1
C 0,0,255
        
11111111111111111
10000000000000001
10100000100000001
10100001110000001
10100000100000001
10100000000000011
1010N000000000101
11111111111111111
