C     0,0,22

NO      ./path_to_the_north_texture     
F       220,100,20
SO       ./path_to_the_south_texture		
WE        ./path_to_the_west_texture   
EA ./path_to_the_east_texture


















11111111111111111     1   1      11     1    1
10000000000000001                1E1
10000000100000001                111
10100001110000001
10100000100000001       111111111111111111111111
10100000000000011       111111111111111111111001
10111000000000101       100000000000000000000001
11111111111111111       111111111111111111111111




