NO    	   ./path_to_the_north_texture				
SO 	./path_to_the_south_texture     
WE   	   ./path_to_the_west_texture				
EA 				./path_to_the_east_texture   	

F      220,80,10	






C       0,0,0             
 
                    




11111111111111111
10000000000000001
10100000100000001
1010000101000001
10100000100000001    1111
10100000000000111    1001
1010N000000000101    1001
11111111111111111    1111
