NO ./path_to_the_north_texture
SO ./path_to_the_south_texture
WE ./path_to_the_west_texture
EA ./path_to_the_east_texture

F 220,100,1
C 0,0,255

11111111111111111
10000000000000001
10000000000000001
10000000000000001
100000000E0000001   1111
10000000000000111   1001
10000000000000101   1111
11111111111111111