NO ./path_to_the_north_texture
SO ./path_to_the_south_texture
WE ./path_to_the_west_texture
EA ./path_to_the_east_texture

F 220,100,0
C 0,0,255

11111111111111111
10000000000000001
10000000000000001
10000000000000001
100000000E0000001    1111111
10000000000000111    1000001
10000000000000101    1000000000
11111111111111111    1111111