
F 255,0,0 

NO ./textures/axe_wall64.xpm   


SO ./textures/brick_wall64.xpm   


C            	     0,0,0     




WE                          ./textures/candle_wall64.xpm     



EA                            ./textures/mold_wall64.xpm   
	

11111111111111111
10000000000000001
10100000100000001
10100001110000001
10100000100000001
10100000000000011
1010W000000000101
11111111111111111