SO ./textures/monettwife_pxl_64.xpm

C 0,0,255
NO ./textures/monaliza_pxl_64.xpm
WE ./textures/noite_pxl_64.xpm
F 220,100,1
EA ./textures/ogrito_pxl_64.xpm

11111111111111111         1
10000000000000001        101111111111111111111111111111
10100000100000001        101                          1
101E0001010000001111111111011111111111111111111       1 
10100000100000000000000000000000000000000000011
101000000000000001111111111111111111111111111111
101000000000001011110000000000000000000011111111
11111111111111111111111111111111111111111111111