NO ./textures/monaliza_pxl_64.xpm
SO ./textures/monettwife_pxl_64.xpm
WE ./textures/noite_pxl_64.xpm
EA ./textures/ogrito_pxl_64.xpm

F 139,69,19
C 200,200,200

1111111111111111111111111111111111111111111
10E0000000000000000010000000100000000000001
1111001010010001111111111110101000000001001
1000101010110000000000000000101000000011111
1110101010011111111111111110101000000001001
1000101010001000101000000000101000000000001
1010101010111010001001111111111111100001001
1010101010001101000000000000000000000001001
1010101010111001011101010010111111100111001
1010101010001101000111111111000000000000001
1010001010101001000100010000000001111000101
1101101010101110011101110111011110100010101
1000001010101000001000000000000010101110101
1111101010101010000010111111111110100010101
1000001000101011111010000000000000100010101
1011101010101010001010111110111100111110101
1010100000001010010010010100100000100010111
1010101010101010101010010000100000100010001
1010101011101010101010010111111110010000001
1010101001001000101110110100100011111100001
1010001010000000100000010010100000000000001
1111111111111111111111111111111111111111111
