SO ./path_to_the_south_texture

C 0,0,255
NO ./path_to_the_north_texture
WE ./path_to_the_west_texture
F 220,100,a
EA ./path_to_the_east_texture

11111111111111111         1
10000000000000001        101
10100000100000001        101
101E0001010000001111111111011111111111111111111
101000001000000000000000000000000000000000000110
10100000000000000111111111111111111111111111111
10100000000000101
11111111111111111

00000000000000
11111111111111